############
#**  #     ###
#**  # @  @  #
#**  #@####  #
#**    P ##  #
#**  # #  @ ##
###### ##@ @ #
  # @  @ @ @ #
  #    #     #        
  ############   
