    #####
    #   #
    #@  #
  ###  @##
  #  @ @ #
### # ## #   ######
#   # ## #####  **#
# @  @          **#
##### ### #P##  **#
    #     #########
    #######
