    #####
    #   #
    #$  #
  ###  $##
  #  $ $ #
### # ## #   ######
#   # ## #####  ⭑⭑#
# $  $          ⭑⭑#
##### ### #@##  ⭑⭑#
    #     #########
    #######
