  #####
###   #    
#*P@  #  
### @*#
#*##@ # 
# # * ##   
#@  @@*#
#   *  #         
########  
