############
#⭑⭑  #     ###
#⭑⭑  # @  @  #
#⭑⭑  #@####  #
#⭑⭑    ♟ ##  #
#⭑⭑  # #  @ ##
###### ##@ @ #
  # @  @ @ @ #
  #    #     #        
  ############    
