##############
#⭑⭑  #     ###
#⭑⭑  #       #
#⭑⭑  # ####  #
#⭑⭑    ♟ ##  #
#⭑⭑  # #    ##
###### #     #
  # @          #
  #            #        
  ##############    
