    #####
    #   #
    #@  #
  ###  @##
  #  @ @ #
### # ## #   ######
#   # ## #####  ⭑⭑#
# @  @          ⭑⭑#
##### ### #♟##  ⭑⭑#
    #     #########
    #######
