  #####
###   #    
#⭑♟@  #  
### @⭑#
#⭑##@ # 
# # ⭑ ##   
#@  @@⭑#
#   ⭑  #         
########  
   
